示例	範例
自包含	自我包含
速覽	速成
元組	Tuple
轉發	轉向
備份和恢復	備份和還原
讀檔案	讀取檔案
寫檔案	寫入檔案
接下里	接下來
死迴圈	無窮遞迴
樹形	樹狀
應答	回應
銷燬	刪除
非關係	非關聯
關係資料庫	關聯式資料庫
單條	單筆
回滾	回復
事務	交易
遞交	提交
時間戳	時戳
咯	囉
顯式	明確
隱式地	隱含的
費解	難以理解
引數	參數
變參	可變參數函式
返回	回傳
大小寫敏感	區分大小寫的
瞭	了
聲明瞭	宣告了
申明	宣告
常量	常數
命令操作工具	命令列工具
新建	建立
多級	多階層
響應	回應
打印	顯示
數組	陣列
語義	語意
生成	產生
創建	建立
素數	質數
磁盤	硬碟
跟蹤	追蹤
和包	和套件
軟件包	套件
軟體包	套件
擴展名	副檔名
復雜	複雜
轉義	跳脫
數組	陣列
教程	課程
